SSSSIIISSSSSSSS
SSSIIIIIISSSSLL
SSSIIIISSSSSSLL
SSSSSSSSSSSSCCC
SSSSSSSSSLLLCCC
SSFCCCSSSSFFFFF
SCCCSSSSSSFFFFF
SCCCLSSSSSSSFFF
SSSLLSSSSSSSSSS
SSSSSSSSSSSSSSS
IIIISSSLLLLCCSS
IIISSSSSCCCCCSS
SSSSSSSCCCLLLSS
ISSSSSFFFFFLLSS
IIISSSSSSSSSSSS