SSSSSSSSSSSSSSS
SSSIIIIIIIIISSS
SSSIIIIIIIIISSS
SSSSSSSSSIIISSS
SSFFCLSSSIIISSS
SSFCCLSSSSSSSSS
SSSSSSSSSSSSSSS
SSSSLLLLLLLCCSS
SSSSLFFFLLLCCSS
SSSSLFFFLLLCCSS
SSSSLLLLLLLCCSS
SSSSLCCCCCCCCSS
SSSSLCCCCCCCCSS
SSSSLLLLLLLLLSS
SSSSSSSSSSSSSSS